╔═══════                       
║· · ·                         
╠·╦═╦═╦═╦═╦═╦═╦═╦═╦═╦═╦═╦═╦═╦═╗
║·║   ║   ║       ║   ║   ║   ║
╠·╬ ╬ ╬ ╬ ╬ ╬ ╬ ╬ ╬ ╬ ╬ ╬ ╬ ╬ ╣
║·║ ║ ║ ║ ║ ║   ║ ║ ║ ║ ║   ║ ║
╠·╬ ╬ ╬ ╬ ╬ ╬ ╬ ╬ ╬ ╬ ╬ ╬ ╬ ╬ ╣
║·  ║ ║ ║ ║ ║   ║ ║ ║ ║   ║   ║
╠·╬ ╬ ╬ ╬ ╬ ╬ ╬ ╬ ╬ ╬ ╬ ╬ ╬ ╬ ╣
║·    ║ ║   ║   ║ ║ ║ ║   ║   ║
╠·╬ ╬ ╬ ╬ ╬ ╬ ╬ ╬ ╬ ╬ ╬ ╬ ╬ ╬ ╣
║·║     ║·······║ ║ ║ ║   ║   ║
╠·╬ ╬ ╬ ╬·╬ ╬ ╬·╬ ╬ ╬ ╬ ╬ ╬ ╬ ╣
║·  ║    ·║   ║·║   ║     ║···║
╠·╬ ╬ ╬ ╬·╬ ╬ ╬·╬ ╬ ╬ ╬ ╬ ╬·╬·╣
║·····║···║ ║ ║·············║·║
╠ ╬ ╬ ╬ ╬ ╬ ╬ ╬ ╬ ╬ ╬ ╬ ╬ ╬ ╬·╣
║       ║ ║ ║ ║     ║     ║ ║·║
╠ ╬ ╬ ╬ ╬ ╬ ╬ ╬ ╬ ╬ ╬ ╬ ╬ ╬ ╬·╣
║         ║ ║ ║   ║ ║   ║   ║·║
╠ ╬ ╬ ╬ ╬ ╬ ╬ ╬ ╬ ╬ ╬ ╬ ╬ ╬ ╬·╣
║ ║   ║   ║ ║ ║   ║         ║·║
╠ ╬ ╬ ╬ ╬ ╬ ╬ ╬ ╬ ╬ ╬ ╬ ╬ ╬ ╬·╣
║ ║ ║ ║ ║ ║ ║ ║             ║·║
╠ ╬ ╬ ╬ ╬ ╬ ╬ ╬ ╬ ╬ ╬ ╬ ╬ ╬ ╬·╣
║ ║ ║ ║ ║ ║ ║ ║   ║ ║       ║·║
╠ ╬ ╬ ╬ ╬ ╬ ╬ ╬ ╬ ╬ ╬ ╬ ╬ ╬ ╬·╣
║   ║   ║   ║   ║   ║       ║·║
╚═╩═╩═╩═╩═╩═╩═╩═╩═╩═╩═╩═╩═╩═╩·╣
                       · · · ·║
                       ═══════╝