╔═══════                       
║······                        
╠·╦═╦═╦═╦═╦═╦═╦═╦═╦═╦═╦═╦═╦═╦═╗
║·║   ║   ║       ║   ║   ║   ║
╠·╬ ╬ ╬ ╬ ╬ ╬ ╬ ╬ ╬ ╬ ╬ ╬ ╬ ╬ ╣
║·║ ║ ║ ║ ║ ║   ║ ║ ║ ║ ║   ║ ║
╠·╬ ╬ ╬ ╬ ╬ ╬ ╬ ╬ ╬ ╬ ╬ ╬ ╬ ╬ ╣
║·  ║ ║ ║ ║ ║   ║ ║ ║ ║   ║   ║
╠·╬ ╬ ╬ ╬ ╬ ╬ ╬ ╬ ╬ ╬ ╬ ╬ ╬ ╬ ╣
║·····║ ║   ║   ║ ║ ║ ║   ║   ║
╠ ╬ ╬·╬ ╬ ╬ ╬ ╬ ╬ ╬ ╬ ╬ ╬ ╬ ╬ ╣
║ ║  ···║·······║ ║ ║ ║   ║   ║
╠ ╬ ╬ ╬·╬·╬ ╬ ╬·╬ ╬ ╬ ╬ ╬ ╬ ╬ ╣
║   ║  ···║   ║·║   ║     ║···║
╠ ╬ ╬ ╬ ╬ ╬ ╬ ╬·╬ ╬ ╬ ╬ ╬ ╬·╬·╣
║     ║   ║ ║ ║···········║·║·║
╠ ╬ ╬ ╬ ╬ ╬ ╬ ╬ ╬ ╬ ╬ ╬ ╬·╬·╬·╣
║       ║ ║ ║ ║     ║    ·║·║·║
╠ ╬ ╬ ╬ ╬ ╬ ╬ ╬ ╬ ╬ ╬ ╬ ╬·╬·╬·╣
║         ║ ║ ║   ║ ║   ║···║·║
╠ ╬ ╬ ╬ ╬ ╬ ╬ ╬ ╬ ╬ ╬ ╬ ╬ ╬ ╬·╣
║ ║   ║   ║ ║ ║   ║         ║·║
╠ ╬ ╬ ╬ ╬ ╬ ╬ ╬ ╬ ╬ ╬ ╬ ╬ ╬ ╬·╣
║ ║ ║ ║ ║ ║ ║ ║             ║·║
╠ ╬ ╬ ╬ ╬ ╬ ╬ ╬ ╬ ╬ ╬ ╬ ╬ ╬ ╬·╣
║ ║ ║ ║ ║ ║ ║ ║   ║ ║       ║·║
╠ ╬ ╬ ╬ ╬ ╬ ╬ ╬ ╬ ╬ ╬ ╬ ╬ ╬ ╬·╣
║   ║   ║   ║   ║   ║       ║·║
╚═╩═╩═╩═╩═╩═╩═╩═╩═╩═╩═╩═╩═╩═╩·╣
                       ·······║
                       ═══════╝