╔══════════                                                  
║ ····                                                       
║ · ╦═══╦═══╦═══╦═══╦═══╦═══╦═══╦═══╦═══╦═══╦═══╦═══╦═══╦═══╗
║ · ║       ║       ║         ····· ║       ║       ║       ║
║ · ║   ║   ║   ║   ║   ║   ║ · ║ · ║   ║   ║   ║   ║   ║   ║
║ · ║   ║   ║   ║   ║   ║   ║ · ║ · ║   ║   ║   ║       ║   ║
║ · ║   ║   ║   ║   ║   ╬═══╬ · ║ · ║   ║   ║   ║   ║   ║   ║
║ ·     ║   ║   ║   ║   ║     · ║ · ║   ║   ║       ║   ║   ║
║ · ║   ╬═══╬   ║   ║   ║   ║ · ║ · ║   ║   ║   ║   ║   ║   ║
║ · ║       ║   ║       ║   ║ · ║ · ║   ║   ║   ║   ║       ║
║ · ║   ╬═══╬   ╬═══╦   ║   ║ · ║ · ║   ║   ║   ║   ║   ║   ║
║ · ║           ║ ············· ║ · ║   ║   ║   ║   ║ ····· ║
║ · ║   ║   ║   ║ · ║   ║   ║   ║ · ║   ╬═══╬   ║   ║ · ║ · ║
║ ····· ║       ║ · ║   ║   ║   ║ ····· ║     ····· ║ · ║ · ║
║   ║ · ║   ║   ║ · ║   ║   ╬═══╬   ║ · ║   ║ · ║ · ║ · ║ · ║
║   ║ ·     ║ ····· ║   ║   ║       ║ ········· ║ · ║ · ║ · ║
║   ║ · ╬═══╬ · ║   ║   ║   ║   ║   ║   ║   ║   ║ · ║ · ║ · ║
║     ········· ║   ║   ║   ║           ║       ║ · ║ · ║ · ║
║   ║   ║   ║   ║   ║   ║   ╬═══║   ║   ╬═══╬   ║ · ║ · ║ · ║
║   ║           ║   ║   ║   ║   ║   ║   ║       ║ ····· ║ · ║
║   ║   ╬═══╬   ║   ║   ║   ║   ║   ║   ║   ║   ║   ║   ║ · ║
║   ║       ║       ║   ║   ║   ║   ║   ║   ║   ║   ║   ║ · ║
║   ║   ║   ║   ║   ║   ║   ║   ║   ║   ║   ║   ║   ║   ║ · ║
║   ║   ║═══║   ║   ║   ║   ║   ║           ║       ║   ║ · ║
║   ║   ║   ║   ║   ║   ║   ║   ║   ║   ║   ║   ║   ║   ║ · ║
║   ║   ║   ║   ║   ║   ║   ║   ║   ║   ║   ║   ║       ║ · ║
╠═══╬   ║   ║   ║   ║   ║   ║   ║   ║   ║   ║   ║   ║   ║ · ║
║       ║       ║       ║       ║       ║           ║   ║ · ║
╚═══╩═══╩═══╩═══╩═══╩═══╩═══╩═══╩═══╩═══╩═══╩═══╩═══╩═══╩ · ║
                                                     ······ ║
                                                     ═══════╝